site_no,q.cfs,da.sq.mi,record.start,record.end,record.length,record.gap
10263500,3.029,22.899990505343975,1950,2020,70,1
10264000,0.0168,48.9999796839238,1950,2005,55,26
10264600,0.02126,15.79999344910196,1959,1986,27,1
10264750,2.57e-4,34.159985836792586,1960,1979,19,1
10276000,8.3193,32.59998648359012,1950,1978,28,1
10277500,17.53,1975.999180723131,1950,1975,25,1
10281800,2.4265,18.09999249549022,1950,1978,28,1
10286000,0.1199,40.09998337398662,1952,1978,26,1
10287400,19.14,51.299978730312056,1950,1979,29,1
10287900,13.92,34.89998552997837,1950,1979,29,1
10289000,4,63.59997363056231,1955,2009,54,31
10289500,4.69,19.499991915030897,1955,2015,60,31
10290500,1.3327,39.09998378860042,1955,2015,60,20
10291500,13.71,44.09998171553142,1955,2015,60,18
10292000,2.23,52.79997810839135,1955,1975,20,1
10293500,26.86,1099.9995439248198,1950,2020,70,17
10295500,12.86,63.09997383786922,1950,2008,58,11
10296000,30.36,180.99992495490218,1950,2020,70,1
10296500,36.7,249.99989634654995,1959,2020,61,1
10297500,22.57,496.9997939369414,1959,2020,61,1
10299100,2.189,50.39997910346447,1966,2015,49,38
10300000,33.2,963.9996003122968,1950,2020,70,17
10308200,50.3,275.99988556659116,1962,2020,58,1
10308783,0.03063,4.1599982752065925,2000,2020,20,1
10308789,0.03116,7.069997068680433,2000,2020,20,1
103087891,0.0914,0.54999977196241,2005,2020,15,1
10308794,0.789,21.399991127264677,2000,2020,20,1
10308800,1.886,31.4999869396653,1963,2017,54,15
10309000,57.6,355.99985239748713,1950,2020,70,1
10310000,16.86,65.39997288425748,1950,2020,70,1
10310400,0.776,3.819998416175283,1967,2019,52,7
10310407,4.637,671.9997213795264,2003,2020,17,1
10310500,1.609,15.4999935734861,1950,2020,70,28
10311000,13.26,885.9996326521731,1950,2020,70,1
10311090,0.17198,1.8299992412567458,1990,2010,20,1
10311100,0.3286,4.059998316667971,1978,2020,42,3
10311200,1.599,5.19999784400824,1978,2020,42,1
10311300,0.04237,34.39998573728527,1986,2020,34,1
10311400,8.878,957.9996027999795,1980,2020,40,7
10336580,1.64,14.089994158091557,1991,2011,20,1
10336600,5.26,33.09998627628322,1962,1986,24,1
103366092,4.52,39.299983705677654,1992,2020,28,1
10336610,4.501,54.89997723770237,1973,2020,47,7
10336626,1.789,16.699993075949536,1970,1992,22,1
10336645,0.74,7.439996915273328,1982,2020,38,1
10336660,1.71,11.199995356325438,1962,2020,58,1
10336674,0.3032,4.9599979435155515,1993,2011,18,1
10336676,0.6704,9.699995978246138,1974,2020,46,1
10336698,1.543,6.04999749158651,1971,2020,49,6
103366993,1.283,2.8499988183506697,1991,2011,20,1
10336700,2.286,6.739997205502988,1971,2020,49,16
10336715,0.02084,2.859998814204532,1975,2018,43,1
10336730,0.10601,4.109998295937282,1973,2020,47,14
10336740,0.059126,2.0899991334571575,1985,2011,26,1
103367592,0.521,0.629999738793306,1991,2011,20,6
10336760,1.814,5.609997674016582,1994,2012,18,1
10336770,3.77,7.39999693185788,1991,2011,20,1
10336775,6.47,23.69999017365294,1992,2014,22,1
10336780,11.29,36.699984783673536,1962,2020,58,1
10337500,21.939,506.9997897908034,1950,2020,70,1
10338000,51.77,552.9997707185686,1950,2020,70,18
10342000,2.343,36.49998486659629,1950,1972,22,1
10343000,1.8571,8.099996641628218,1970,2020,50,1
10343500,1.84,10.4999956465551,1955,2020,65,1
10344400,26.429,145.99993946638517,1950,2020,70,4
10346000,298.6,931.9996135799383,1950,2020,70,1
10347310,0.461,24.19998996634604,1994,2020,26,7
10347460,234.71,1034.999570874717,1994,2020,26,3
10347600,4.21,11.499995231941298,1963,2020,57,23
10348000,180.82,1066.9995576070753,1950,2020,70,1
10348200,149.094,1069.999556363234,1978,2020,42,1
10348460,1.073,3.2399986566512884,1976,2018,42,1
10348850,4.143,7.689996811619878,1986,2020,34,8
10348900,0.45165,8.4999964757827,1963,1994,31,1
10349300,1.0743,122.99994900250258,1963,2020,57,1
10349495,0.00594,139.999941954068,2002,2009,7,1
10349980,13.8695,243.9998988342328,1979,2020,41,3
10350000,267.71,1430.999406687652,1950,2020,70,6
10350340,301.9,1579.999344910196,1998,2020,22,1
10350400,252.7,1589.999340764058,1973,1997,24,1
10353770,9.75e-4,30.9999871469722,1975,2000,25,1
10356500,3.876,183.99992371106077,1952,1994,42,1
10358500,10,89.99996268475799,1952,1994,42,1
10359300,0.0226,225.99990629728117,1962,1982,20,5
10360900,3.1,25.599989385886715,1962,1982,20,1
10370000,4.24,62.9999738793306,1952,1973,21,1
10371000,4.21,66.99997222087539,1952,1973,21,3
10371500,12,248.9998967611638,1950,1991,41,1
10378500,0.293,169.99992951565397,1951,1991,40,1
11181390,0.01511,7.789996770158497,1977,1996,19,1
11182100,0.00363,9.999995853861998,1950,1977,27,1
11186000,41.286,845.9996492367252,1962,2019,57,1
11187000,154.6,1008.9995816546757,1955,1993,38,1
11189500,4.451,529.999780254686,1950,2020,70,4
11192500,17.095,2257.9990638020395,1952,2019,67,8
11194000,174,2406.999002024583,1950,1976,26,1
11195500,0.8,48.799979766846555,1960,1981,21,1
11196400,0.00497,164.999931588723,1963,1983,20,1
11196420,0.00256,53.199977942545836,1964,1985,21,1
11197250,0.0037,57.09997632555202,1963,1986,23,1
11197800,1.1674,229.99990463882597,1961,1985,24,1
11199500,0.00992,90.59996243598971,1950,2005,55,19
11200800,0.5128,83.29996546267044,1970,2020,50,1
11202000,3.2,39.299983705677654,1950,2019,69,8
11203580,1.99,20.09999166626262,2001,2020,19,1
11204100,1.4251,95.79996027999795,2002,2020,18,1
11204500,0.2383,108.99995480709579,1950,1990,40,3
11206500,9.429,101.99995770939239,1951,2003,52,4
11208000,1.738,51.399978688850666,1951,2019,68,3
11208730,5.435,85.79996442613596,1954,2019,65,17
11209900,33,417.9998266914316,1960,1990,30,1
11210100,0.511,86.69996405298355,1960,1990,30,1
11211300,0.0221,75.5999686551967,1961,1994,33,1
11213500,141.9,951.9996052876622,1950,1982,32,1
11214000,1.571,37.699984369059734,1958,1981,23,1
11215000,9.61,180.99992495490218,1950,2019,69,7
11216500,11.14,249.99989634654995,1961,2019,58,1
11218400,33.71,386.9998395444594,1961,2019,58,1
11218500,181.6,1341.9994435882802,1963,1993,30,1
11220000,0.4503,69.999970977034,1955,1973,18,1
11220500,0.0215,56.09997674016582,1954,1973,19,1
11221700,0.0419,126.99994734404738,1959,1994,35,1
11224500,0.0054,95.79996027999795,1950,2020,70,1
11226500,51.1,248.9998967611638,1953,1991,38,1
11230215,13,183.99992371106077,1977,2019,42,3
11230500,5.49,52.49997823277549,1950,2019,69,1
11234760,11,1002.9995841423585,1961,2019,58,1
11237500,0.2629,22.899990505343975,1950,2019,69,1
11237700,0.1601,22.999990463882597,1988,2019,31,3
11238500,3.128,130.9999456855922,1988,2019,31,1
11238600,3.97,1196.9995037072813,1975,2019,44,7
11239300,4.01,4.4199981674070035,1990,2019,29,1
11241500,2.6416,29.399987810354276,1988,2019,31,1
11242000,5.616,1294.999463075129,1952,2019,67,1
11242400,1.826,16.89999299302678,1967,2009,42,3
11244000,0.3,50.79997893761895,1950,2019,69,1
11246500,0.6289,129.999946100206,1953,2019,66,1
11246700,27.1,1460.999394249238,1988,2019,31,1
11247000,500.1,1479.9993863715758,1950,1981,31,1
11251000,49.1,1675.9993051072709,1950,2020,70,1
11253310,0.00282,46.39998076191968,1968,2020,52,1
11257100,0.72316,10.599995605093719,1962,1980,18,1
11257500,0.5739,132.9999448563646,1950,1990,40,1
11258900,0.0183,33.59998606897632,1959,1980,21,1
11260480,0.0302,65.69997275987333,1960,1980,20,1
11261500,51.5,7614.996842715913,1950,2020,70,17
11264500,6.8,180.99992495490218,1950,2020,70,1
11266500,18.57,320.99986690897015,1950,2020,70,1
11268000,10.43,240.9999000780742,1952,1975,23,1
11269300,0.00842,16.9999929515654,1961,1980,19,3
11271320,0.0184,67.59997197210711,1968,1992,24,1
11272500,114.947,1272.9994721966325,1950,2010,60,8
11275000,0.144,45.99998092776519,1950,1983,33,2
11276500,41.426,456.9998105214934,1950,2020,70,1
11276600,41.1,483.9997993269207,1972,2020,48,3
11278000,4.917,78.39996749427809,1950,2020,70,1
11278300,11.371,225.99990629728117,1958,2020,62,3
11278400,75.86,233.99990298037076,1964,2020,56,1
11281000,6.571,86.99996392859939,1950,2002,52,3
11282000,1.6499,73.4999695258857,1950,2002,52,3
11283500,7.76,143.9999402956128,1961,1995,34,5
11284400,0.0091,16.39999320033368,1970,2020,50,1
11284700,0.703,23.09999042242122,1964,1986,22,1
11290000,216.9,1883.9992188676006,1950,2020,70,1
11292000,16.71,47.499980305844495,1950,2019,69,1
11292500,22.71,67.4999720135685,1952,1994,42,1
11292700,23,286.99988100583937,1957,2019,62,3
11293500,3.81,27.799988473736356,1954,1987,33,1
11294500,33,165.99993117410918,1950,2019,69,1
11295400,39,628.9997392079198,1969,1994,25,1
11296500,13,44.79998142530175,1950,2019,69,1
11297200,4.91,48.099980057076216,1977,2016,39,23
11298000,1.988,66.89997226233679,1950,2019,69,1
11299600,0.00893,14.39999402956128,1985,2020,35,1
11303000,181.714,1074.999554290165,1950,2020,70,1
11306000,0.0791,117.99995107557159,1951,1979,28,1
11308000,0.0455,85.19996467490424,1951,1979,28,1
11309000,0.00762,21.09999125164882,1950,1969,19,1
11315000,0.1647,20.9999912931102,1950,2019,69,1
11316000,2.6,47.9999800985376,1953,1987,34,1
11316600,34.29,332.99986193360456,1971,2001,30,1
11316800,2.0143,20.79999137603296,1962,2019,57,1
11317000,5.2797,68.39997164041607,1950,2019,69,1
11318500,6.0689,75.0999688625036,1950,2019,69,1
11319500,262.86,543.9997744500928,1950,2019,69,1
11325500,31.857,660.9997259402782,1950,2019,69,4
11327000,0.0302,48.099980057076216,1962,1980,18,1
11329500,0.133,323.99986566512877,1950,1987,37,1
11333000,3.1292,62.59997404517611,1956,2004,48,1
11333500,7.323,204.99991500417102,1950,1987,37,1
11334300,0.0449,64.29997334033266,1959,1980,21,1
11335000,9.919,535.9997777670031,1950,2020,70,1
11336000,0.543,723.9996998196087,1950,1982,32,1
11339500,0.7413,211.9999121018744,1950,1981,31,3
11340500,0.2218,32.899986359205975,1950,1981,31,1
11341400,44.1,134.999944027137,1961,1987,26,1
11342000,194,424.999823789135,1950,2020,70,1
11345500,5.61,246.99989759039138,1950,2020,70,1
11348500,9.279,1430.999406687652,1950,2020,70,1
11350500,11.76,257.9998930296396,1959,1982,23,1
11352000,1.179,2474.9989738308445,1953,1975,22,1
11355500,121.4,161.99993283256438,1950,2020,70,23
11360500,8.84,94.5999607775345,1959,1980,21,3
11363000,96.1,4710.998046754388,1950,2019,69,1
11365000,2030,4951.997946832462,1950,2019,69,3
11367500,753,357.9998515682596,1950,2019,69,1
11367800,168.6,426.9998229599073,1966,2019,53,1
11368000,282,603.9997495732648,1950,2019,69,3
11370500,3424,6467.997318277941,1950,2020,70,1
11371000,10.43,114.99995231941298,1952,1993,41,1
11372000,50.43,227.99990546805358,1950,2020,70,1
11374000,19.714,424.999823789135,1951,2020,69,1
11375700,4.657,88.69996322375594,1958,1980,22,1
11376000,52.1,926.9996156530074,1950,2020,70,1
11377100,5007,8899.99630993718,1950,2020,70,1
11378800,0.0486,93.4999612336097,1961,1982,21,1
11379000,34.9,122.99994900250258,1950,1982,32,1
11379500,1.357,92.39996168968489,1950,2020,70,1
11380500,0.112,135.9999436125232,1951,1969,18,1
11381500,98.7,130.9999456855922,1950,2020,70,1
11382000,2.393,202.99991583339857,1950,1996,46,1
11383500,87.4,207.9999137603296,1950,2020,70,1
11384000,21.1,72.39996998196088,1950,1986,36,1
11388500,0.437,772.9996795035325,1950,1973,23,1
11390000,92.5,146.9999390517714,1950,2020,70,1
11392500,16,685.9997155749331,1950,1979,29,1
11394500,154.7,1061.9995596801443,1953,1986,33,1
11396000,1.6053,29.999987561585996,1950,2019,69,1
11396400,3.343,18.69999224672194,1967,1987,20,1
11399500,33.324,492.9997955953965,1950,2019,69,1
11400500,45.9,69.29997126726366,1950,2019,69,7
11401200,30.6,525.9997819131411,1959,1980,21,4
11401500,15.143,738.9996936004018,1950,1993,43,1
11402000,21.23,183.99992371106077,1950,2020,70,1
11403000,69.4,1024.999575020855,1952,1982,30,8
11404330,132.1,1913.9992064291866,1988,2019,31,1
11404500,56.1,1952.9991902592483,1950,2019,69,1
11405300,0.837,109.999954392482,1959,1986,27,1
11407000,619,3623.9984974395884,1950,2019,69,1
11407150,1084,3675.9984758796704,1966,1998,32,1
11407300,0.0484,47.09998047169002,1962,1981,19,3
11407500,0.0421,30.59998731281772,1952,1986,34,1
11408500,0.0428,39.79998349837076,1950,1995,45,26
11408850,30.4,135.9999436125232,1969,1989,20,1
11409000,32,161.99993283256438,1950,1969,19,1
11409300,1.743,22.999990463882597,1969,2000,31,1
11409500,4.4,34.39998573728527,1950,1969,19,1
11413000,130.3,249.99989634654995,1950,2020,70,1
11413320,2.41,3.159998689820392,1996,2019,23,3
11413323,0.914,2.0699991417494337,1996,2019,23,4
11414000,5.871,51.79997852300515,1950,1994,44,1
11414250,5.44,119.99995024634399,1967,2019,52,1
11417000,16.1,197.99991790646757,1950,1972,22,5
11417500,37.57,307.9998722989496,1960,2019,59,1
11418500,2.549,84.5999649236725,1950,2020,70,1
11421000,333.6,1338.9994448321218,1950,2020,70,1
11421770,5.33,12.29999490025026,1967,2015,48,5
11421790,5.7,21.4999910858033,1967,2019,52,2
11424000,9.829,291.99987893277034,1950,2020,70,1
11425000,967,5920.99754507169,1950,1983,33,1
11426150,0.2,3.5799985156825955,1961,1979,18,1
11426200,0.29024,1.6799993034488157,1958,1985,27,1
11426400,0.3207,9.099996227014419,1958,1985,27,1
11427500,7.743,47.89998013999897,1953,2019,66,1
11427700,0.577,9.939995878738827,1963,2019,56,1
11427760,15.43,87.79996359690836,1967,2019,52,1
11428000,1.0559,31.399986981126673,1958,1986,28,1
11430000,5.21,47.59998026438312,1963,2018,55,3
11431800,3.486,11.699995149018537,1962,2008,46,1
11433040,1.543,21.09999125164882,1963,2008,45,1
11433100,0.767,17.9999925369516,1962,1992,30,1
11433200,37.4,314.99986939665297,1960,1984,24,1
11433260,23.29,88.89996314083318,1967,1985,18,1
11433300,107.6,523.9997827423688,1960,2019,59,1
11433500,88.9,613.9997454271268,1950,1985,35,3
11435100,2.1429,8.759996367983112,1972,2019,47,1
11439500,7.057,192.99991997953657,1950,2019,69,1
11440000,0.5,21.999990878496398,1950,1981,31,1
11442500,28.7,448.9998138384038,1971,1993,22,1
11443500,12.86,492.9997955953965,1950,2019,69,1
11444500,281.1,597.9997520609476,1966,2019,53,1
11445500,195.7,672.9997209649125,1953,1995,42,1
11448500,0.012,6.359997363056231,1956,1978,22,1
11449100,0.079,55.19997711331824,1962,1980,18,1
11449500,2.3,36.59998482513492,1950,2020,70,1
11451000,2.265,527.9997810839136,1950,2020,70,1
11451100,0.378,60.19997504024924,1973,2020,47,1
11451300,6.6,120.99994983173018,1985,2020,35,6
11451500,1.203,196.9999183210814,1950,1981,31,1
11451715,1.2588,94.89996065315037,1999,2020,21,1
11451720,0.7635,99.99995853861999,1960,1980,20,1
11452000,10.3,1043.9995671431927,1950,1975,25,1
11452500,0.515,1138.9995277548817,1950,2020,70,1
11456000,0.2205,78.79996732843256,1950,2020,70,7
11458000,0.227,217.99990961419158,1961,2020,59,1
11458500,0.2568,58.39997578655408,1956,2020,64,22
11459500,0.0122,17.59999270279712,1950,2020,70,1
11460000,0.0917,18.09999249549022,1952,2020,68,21
11460400,7.1,34.29998577874665,1984,2020,36,1
11460600,6.4757,81.69996612605253,1976,2020,44,1
11460750,4.643,31.09998710551082,1985,2020,35,1
11460800,0.052,40.09998337398662,1961,1984,23,1
11461000,0.227,99.99995853861999,1954,2020,66,1
11461500,51.57,92.19996177260764,1950,2020,70,1
11462000,30.751,104.99995646555098,1953,2011,58,3
11462500,129.9,361.99984990980437,1950,2020,70,1
11463000,138,502.99979144925857,1953,2020,67,1
11463170,0.77,13.099994568559218,1982,2020,38,1
11463200,3.3225,85.49996455052009,1959,2020,61,19
11463900,0.3303,43.69998188137694,1962,2020,58,33
11464000,127.6,792.9996712112566,1950,2020,70,1
11464500,0.4357,87.79996359690836,1950,1980,30,1
11465200,33.304,161.99993283256438,1961,2020,59,1
11465350,74.5,216.9999100288054,1989,2020,31,17
11465680,0.0899,40.799983083756956,2000,2020,20,1
11465700,0.00787,6.779997188918435,2000,2020,20,1
11465750,0.078,79.59996699674151,2000,2020,20,1
11466320,1.1783,77.5999678259691,2000,2020,20,1
11467000,124.86,1337.9994452467356,1950,2020,70,1
11467200,0.477,62.79997396225335,1961,2020,59,39
11467600,10.43,98.4999591605407,1964,1983,19,1
11468000,6.114,302.99987437201855,1952,2020,68,1
11468500,3.77,105.9999560509372,1953,2020,67,1
11471500,5.502,348.99985529978375,1950,2019,69,1
11472150,5.973,527.9997810839136,1968,1994,26,1
11472200,1.037,160.9999332471782,1958,1994,36,1
11472900,3,161.99993283256438,1960,2005,45,28
11473900,9.514,744.9996911127189,1967,2020,53,1
11474500,1.543,247.9998971757776,1955,2005,50,27
11475000,26.57,2106.9991264087234,1957,2020,63,1
11475500,1.93,43.89998179845418,1950,1970,20,1
11475560,0.66,6.4999973050103,1969,2020,51,1
11475800,17.43,247.9998971757776,1967,2020,53,6
11476500,35.6,536.9997773523894,1950,2020,70,1
11476600,0.9786,28.099988349352223,1962,2018,56,1
11477000,92,3112.9987093072405,1950,2020,70,1
11478500,8.2,221.99990795573638,1952,2020,68,1
11480390,0.221,93.79996110922555,1982,2020,38,1
11480500,20.14,142.9999407102266,1955,1994,39,1
11481000,28.571,484.9997989123069,1952,2020,68,1
11481200,4.3,40.499983208141096,1957,2020,63,1
11481500,3.6,67.69997193064573,1955,2020,65,16
11482500,14,276.99988515197737,1955,2020,65,1
11489500,11,18.59999228818332,1954,1979,25,1
11507500,265.6,3809.9984203214217,1963,2020,57,1
11509500,323,3919.998374713904,1950,2020,70,1
11516900,2.79,48.19998001561484,1959,1978,19,1
11517000,23.67,672.9997209649125,2003,2020,17,1
11517500,17.43,792.9996712112566,1950,2020,70,1
11519500,32.14,652.9997292571886,1950,2020,70,1
11520500,1057,6939.997122580227,1953,2020,67,1
11521500,41,119.99995024634399,1958,2020,62,2
11522500,154.3,750.9996886250361,1950,2020,70,1
11523000,1691,8474.996486148044,1950,2020,70,1
11523200,31.1,148.9999382225438,1959,2020,61,1
11525500,267.6,718.9997018926778,1950,2020,70,1
11525530,1.236,22.299990754112258,2004,2020,16,1
11525600,9.46,30.799987229894956,1977,2005,28,1
11525655,300,809.9996641628219,1982,2020,38,13
11525854,327,930.9996139945522,2004,2020,16,1
11526250,346,1056.9995617532134,2004,2020,16,1
11526500,21.29,150.9999373933162,1958,1980,22,1
11527000,370,1438.9994033707417,1958,2020,62,1
11528500,23.9,377.99984327598355,1955,1974,19,1
11528700,54.1,763.9996832350568,1967,2020,53,1
11530000,533,2852.9988171068285,1950,2020,70,1
11530500,2551,12099.99498317302,1952,2020,68,4
11532500,229,613.9997454271268,1950,2020,70,1
14362000,97.5,224.999906711895,1950,2020,70,1
14362250,0.00508,15.999993366179199,1985,2020,35,1
14366000,74.76,482.9997997415346,1950,2020,70,1
14369500,178,697.9997105995675,1950,2020,70,25
14372500,8.49,42.29998246183625,1950,1991,41,1
14375100,22.9,83.89996521390218,1967,2020,53,19
14375500,4.33,42.399982420374876,1956,1985,29,1
14377100,29.4,379.99984244675596,1963,2020,57,1
14378200,164,987.9995903615655,1962,1981,19,1
